from Friends serial:
word of advice - небольшой совет
have issues - испытывать трудности в чем-л.
cave - пещера; впадина; подземелье
fluff - взбивать; распушить
twirly - ненормальный (сленг)

CHAPTER 1
fabricator - производитель (продукции); выдумщик; сочинитель (разг.)
be overwhelmed with work - зашиваться с работой
dashboard - приборная панель
hood scoop - воздухозаборник в капоте двигателя
tire - утомлять (чем-либо, от чего-либо); уставать
dive right in - приступить к делу
lay a foundation - заложить основу
pattern - образец; выкройка
immediate - срочный; оперативный
pay-off - результат; отдача
vise jaw - губка тисков
vise - сжимать; стискивать; зажимать в тиски
steppingstone - трамплин; ступенька
rewarding – стоящий
riveting - расплющивание; наклёпывание; склепка
proficient - опытный; специалист
perseverance - упорство; настойчивость
short cut - кратчайшее расстояние
be crucial to - решающее значение для
overlooked - незамеченный; упускаемый из виду
eliminate - исключать; устранять
precise - определённый; точный
placement – размещение
chore - обязаловка; рутинная работа
into the metal shipping vocabulary:
woven - ткань ( weave - ткать; ткать плести; вплетать)
caster - ролик (на ножках мебели); колёсико
secure -  надёжный; убеждённый (в чем-л.)
grind in - притирать; пришлифовывать; притереть
mounted - установленный; смонтированный
bolted - соединённый болтами
come loose - развинтиться; развинчиваться; раскрепляться; сняться
withstand - устоять (перед чем-л.); выдерживать (действие чего-л.)
pounding - вибрирование; бой; грохот
recess - перемена; укромный уголок; уединённое место
chip off - оббиваться; оббить
rack - стеллаж; рама; каркас
tape measure - мерная рулетка; рулетка; сантиметр (портновский)
proficient - знаток; специалист; эксперт; мастер; пряморукий (сл.)
initial design - эскизное проектирование
lethal - смертельно опасный
sag - свисать; прогнуть; прогиб; перекос
heavy-gage - большая толщина; большого сечения
up against - близко; лицом к лицу (с чем-л.)
painstakingly - тщательно; дотошно
irritating - раздражающий
time-consuming - трудоёмкий
extinguisher - огнетушитель
welding torch - сварочная горелка (кислородно-газовая); сварочная горелка (дуговая)
misdirected - неправильно направлять

CHAPTER 2
tinner's snips - ножницы для резки жести
hole saw - корончатое сверло
essential - обязательный; необходимый
invaluable - бесценный
durability - выносливость; живучесть
durable - прочный
air industry - авиационная промышленность
file - напильник; подшивка (газет)
heavy-duty - предназначенный для тяжёлого режима работы
band saw - ленточная пила
tang - хвостовик; острый запах
tapered - сужать (сводить на конус); сужаться (сходить на конус); суживаться (сходить на конус)
dull - делать тупым (нож и т.п.); иступиться
file card - проволочная щётка для чистки напильников
mallet - колотушка; киянка
dolly - клепальная поддержка; куколка
mar - портить; повреждать; искажать
raw-hide - невыделанная кожа
belt sander - шлифовальный ленточный станок
conjunction - соединение; сочетание
divider - циркуль
square - угольник
measure tape - рулетка
versatile - универсальный; многофункциональный; практичный
protractor - угломер
gage - лерка
bevel protractor - угломер-транспортир
steel rule - стальная линейка
wheelhouse - арка колеса
opening - проём; зазор (между валками); вырез (выемка)




















