TEST 7
PAPER 1 (READING) 1.12.19
part 1:
1. C+
2. D -> A
3. D -> A
4. B+
5. B -> D
6. D -> C
7. A+
8. C -> B

part 2:
9. F+
10. B -> H
11. E+
12. D -> A
13. C+
14. A -> G
15. H -> B

part 3:
16. B -> A
17. C+
18. D+
19. F+
20. B+
21,22. A,D -> C,+
23. C+
24. A-> B
25. E+
26. B -> A
27. E+
28,29. F,D +,+
30. A+

correct - 17
mistakes - 13
result - 57%
time 1 hour and 10 minutes

vocabulary:
try one's hand (at something) - попробовать свои силы в чём-либо
on the list - в списке
delicate - изысканный
fine line - тонкая грань [there is a fine line between arrogance and self-confidence],  золотая середина
charm - обаяние; очарование
fireplace - камин
considering - принимая во внимание
have nothing to do with - не иметь ничего общего с
I do wish - мне действительно жаль
provided - в том случае если
will come in handy - пригодятся [This money will come in handy when we go on vacation]
electricity supply - электроснабжение
take offence - обижаться (на-at) [Marianne seemed to take offence at my comments on her work]
engage in crime - вступить на путь преступления
consequence - следствие; последствие
this has resulted in - это привело к
as and when - в случае, когда 
run out - закончиться
in bulk - на развес; оптом; навалом
washing-up liquid - средство для мытья посуды
yet - однако; тем не менее; впрочем; [до сих пор; ещё; уже (в вопросительных предложениях); пока ещё (в вопросительном и отрицательном предложениях)]
far from - далеко не [Yet the epidemic is far from over - Несмотря на это, с эпидемией еще далеко не покончено]

to name but a few - и это только небольшая часть [Many factors can cause the impoverishment of a country: armed conflicts, natural disasters, 
famine and disease, to name but a few. - Многие факторы могут быть причиной обнищания страны: вооруженные конфликты, стихийные бедствия, голод и 
болезни - я назвал лишь немногие из них.]

convene -  созывать (собрание, съезд)
convince - убеждать; уверять
up to date - современный
alike - будь то; как ..., так и [This guarantee applies to aliens and citizens alike - Эта гарантия распространяется как на граждан, так и на иностранцев]
be appropriate - быть кстати; целесообразно [Full recosting might not be appropriate in the present global crisis]
pay for itself - самоокупиться; отбиться [The project must pay for itself in 5-7 years]
facility -  средства обслуживания; техническое средство; механизм
preference - предпочтение
the world over - во всём мире; по всему миру [Stay, and you can be remembered, known the world over]
complain about - пожаловаться на
at the front desk - на ресепшене
favor - услуга; одобрение
particularly true - особенно актуально [This was particularly true in the 1980s and 1990s]
welcoming - гостеприимный
incredible - неимоверный
the year before last - в позапрошлом году
dream - заветный (as adjective)
out of interest - из любопытства [Out of interest, where is Melody?]
anticlimax - спад; разочарование
go all right - идти на лад; хорошо прошло [So did everything go all right with the annulment? - Всё хорошо прошло с аннулированием?]
moan - кряхтеть; охать
take one's mind off smth - отвлекаться от чего-л. [Catastrophe helps take one's mind off tragedy.]
in a way - отчасти; в определенной степени [But in a way, Jesse's right.]
keen on - страстно увлечённый чем-либо
add up to - давать вкупе [Or it could be a pictogram, where the images add up to a message - Или это ребус, в котором картинки складываются в сообщение]
it's an act - это игра [Do you think that it's an act? - Думаешь, это игра?]

PAPER 3 (USE OF ENGLISH) 30.11.19
part 1:
1. D+
2. A+
3. A+
4. C -> D
5. A+
6. B+
7. B+
8. D -> C
9. D+
10. B -> A
11. D+
12. B+

part 2:
13. DID+
14. WITH+
15. HIM -> SUCH
16. TO+
17. THAT -> THOSE
18. SO -> ONLY/JUST
19. HAD -> COULD/WOULD
20. HIMSELF -> IT
21. THAT -> NOTHING
22. TOO -> BUT/ALTHOUGH
23. ONE -> WHICH
24. AT -> FOR

part 3:
25. ATTRACTIVE+
26. TOURISTS+
27. ACHIEVEMENT+
28. EMPLOYER -> EMPLOYEE
29. UNCLEAR+
30. TRADITIONAL+
31. SUCCEEDING -> SUCCESS
32. APPEARING -> APPEARANCE
33. ORIGIN -> ORIGINALITY
34. COMMUNICATION(S)+

part 4: 
35. MY HOLIDAY I HAD+
36. OUGHT TO LOCK -> OUGHT TO HAVE LOCKED
37. ANY CHANCE THAT PETE -> ANY CHANCE OF PETE
38. PAUL NOBODY HAVE -> FROM PAUL NOBODY HAS
39. BEEN USED WITH -> GOT USED TO
40. FELT GOOD TO DO -> FELT LIKE DOING
41. UNABLE TO SING -> BEING UNABLE TO SING
42.AS SOON AS WE GET -> AS SOON AS WE ARRIVE

correct - 19
mistakes - 23 
result - 45%
time: 45 minutes

vocabulary:
whereas - то время как; тогда как
nevertheless - тем не менее; несмотря на это
associate with -  связывать с (кем-л., чем-л.)
in other words - иначе говоря; другими словами
stallholder - торговец
common sight - привычное явление
haggling - торг
haggle - торговаться; придираться

paper 4 (LISTENING)

vocabulary:
chase up - отследить
wrong way round - навыворот [The number on my ticket, the wrong way round - Номер на моём билете написан наоборот]
[The lyrics are the wrong way round -  Стихи идут не в том порядке]
оказываться, как правило (Women tend to be at greater risk than men of long-term economic loss)
loads of - куча; очень много
play about -  1. ходить налево; 2. баловаться [I'm not really a painter; I just like to play about with paints]
come across - случайно наткнуться
stroke -  отдельное движение или усилие; штрих
rowing machine - гребной тренажёр
brand-new - с иголочки; новёхонький
fold up - складывать; закругляться (It's time to fold up and go home) (в сложенном состоянии)
kidney-shaped - овально-изогнутый
packing case - упаковочный ящик
essential items - первостепенные вопросы
hang on to - не выбрасывать (Hang on to your ticket till the end of your trip)
kitchenette - уголок-кухня
work for - работать на (кого-л.)
подменить (Can you fill in for me during my shift? Можешь подменить меня в мою смену?)
kit - комплект; комплект или набор инструментов
move on to - подсесть на (She moved on to drugs)
be in difficulties - испытывать материальные затруднения
eventually - в конце концов
such a large (page 63)
at the first time - в первое время
for the first time - в первый раз; впервые
drawing office - КБ; конструкторское бюро
change one's mind - передумать; изменить решение
any chance of (page 65) [I'm afraid there isn't any chance of that]
apart from - кроме; помимо; за исключением
feel like doing - иметь желание сделать (что-л.) [But today I feel lazy. I don't feel like doing anything]